##############################
##############################
#                            #
#          ~ .  &            #
#                    *       #
#                ~   @       #
#          #####             #
#   ##  ####   #         *   #
#   #   #      #   ~         #
#   # #### ##  ###  ######## #
#   # #     # ~  ## #      # #
#   # # ### ###     #  ### # #
#   # #       #######    # # #
#   # # ###############  # # #
#   # #                  # # #
#   # #################### # #
#   #                      # #
##############################