##############################
##############################
#          ~ .  &            #
#                    *       #
#                ~   @       #
#          #####             #
#   ##  ####   #         *   #
#   #   #      #   ~         #
#   # #### ##  ###  ######## #
#   # #     # ~  ## #     X# #
#   # ## ## ###     #  ##### #
#   # #     ~ #######    # # #
#   # # ## ############  # # #
#   # #    #    #        # # #
#   # #### ## ### ######## # #
#   #    #      #          # #
#   #        #     #       # #
##############################